ID
ROOM_10
END
BACKGROUND
files/backgrounds/desert_01.PNG
TILES
  . = none
  w = files/textures/gravel_01
  c = files/textures/cloud_02
  f = files/textures/gravel_02
  p = files/textures/gravel_01
  d = none
  e = none
END
LAYOUT
  cccccccccccccccccccccccccccccccccccccccccccccccccccccccccccc
  w..........................................................w
  w..........................................................w
  w..................................................pppp....w
  w..........................................................w
  w..........................................................w
  w..........................................................w
  w....ppppppppp.............................................w
  w..........................................................w
  w..........................................................w
  w..........................................................w
  w..........................................................w
  w..........................................................w
  w..........................................................w
  w.........................................p................w
  w.........................................w................w
  w.........................................w.............pppw
  w.........................................w................w
  w..................ppppppppppp............w................w
  w.........................................w................w
  w.........................................w....pppp........w
  w.........................................w................w
  w...ppppp.................................w................w
  w.........................................w................w
  w.........................................w................w
  w.........................................w................w
  w.........................................w.......pppppppppw
  w.........................................w................w
  w........................pppp.............w................e
  w.........................................w................e
  d.........................................w................e
  d.........................................w................w
  d.........................................w................w
  ffffffffffffffffffffffffffffffffffffffffffffffffffffffffffff
END
GATES
  gate_18 d -1
  gate_19 e -1
END
ENEMY
  e_1 53 2
  e_1 57 15
  e_2 10 6 4,6 13,6
END