ID
ROOM_11
END
BACKGROUND
files/backgrounds/dungeon_01.png
TILES
  . = none
  w = files/textures/gravel_01
  c = files/textures/cloud_02
  f = files/textures/gravel_02
  p = files/textures/gravel_01
  < = files/textures/door_01
  d = none
  l = none
END
LAYOUT
  cccccccccccccccccccccccccccccccccccccccccccccccccccccccccccc
  w..............................w...........................w
  w..............................w...........................w
  w..............................w...........................w
  w..............................w...........................w
  w..............................w...........................w
  w..............................w...........................w
  w..............................w...........................w
  w..............................w...........................w
  w..............................w...........................w
  w..............................w...........................w
  w..............................w...........................w
  w..............................w...........................w
  w..............................w...........................w
  w..............................w...........................w
  w..............................w...........................w
  w..............................w...........................w
  w..............................w...........................w
  w..............................w...........................w
  w..............................w...........................w
  w..............................w...........................w
  w..............................w...........................w
  w..............................w...........................w
  w..............................w...........................w
  w..............................w...........................w
  w..............................w...........................w
  w..............................w...........................w
  w..............................w...........................w
  w..............................w...........................w
  w..............................w...........................w
  d..............................w...........................w
  d..............................<...........................w
  d..............................<...........................w
  fffffdddffffffffffffffffffffffffffffffffffffffffffffffffffff
END
GATES
  gate_22 d -1
END