ID
ROOM_2
END
BACKGROUND
files/backgrounds/dungeon_01.png
TILES
  . = none
  w = files/textures/brick_01
  c = files/textures/wood
  f = files/textures/gravel_01
  p = files/textures/gravel_01
  d = files/textures/door_01
END
LAYOUT
  wcccccchhhhccccccccccccccccccccccccccccccccccccccccccccccccw
  w..........................................................w
  w..........................................................w
  w.......pp.................................................w
  w.........ppp..............................................w
  w..........................................................w
  w.....................pppp.................................w
  w.................................pppp..................pppw
  w.................................w..w.....................w
  w.................................w..w.....................w
  w.................................w..w.....................w
  w....................ppppppppppppppppp.....................w
  w....................w.....................................w
  w....................w.....................................w
  e....................w.....................................w
  e....................w.....................................w
  wppppppppppppppppppppp.....................................w
  w..........................................................w
  w..........................................................w
  w..........................................................l
  w..........................................................l
  w.........................................pppppp..pp..pppppw
  w.........................................w.......ww.......w
  w.........................................w.......ww.......w
  w.........................................w................w
  w.........................................w................w
  w.........................................w................w
  w.........................................w................w
  w.........................................w................w
  w..........pppppppppppppppppppppppppppppppp................w
  w..........w...............................................w
  d..........<...............................................w
  d..........<.............................pp......pp........w
  ffffffffffffffffffffffffffffffffffffffffffffffffffffffffffff
END
GATES
  gate_04 e -1
  gate_03 d -1
  gate_05 h -1
  gate_06 l 1
END
COORDINATES
  0,0
END